*********G*******************
*       *                   *
* ******** **************** *
* *            *            *
* ****** ***** ************ *
*              *            *
* ****** ****************** *
* *                         *
* ***************************
*         *         *       *
* **** ************** *******
*                           *
********** *** ****** ***** *
*            *      *       *
****** **********************
*                           *                   
* ****** ****************** *
* *            *            *
* ****** ****************** *
*              *            *
******** ********************
*                           *
********S********************
